++++++++++++++++++++++
+ + ++ ++             
+                    +
+ + +                +
+++ + ++             +
+ + + ++ ++++ + ++   +
+++ ++++++ +++ + +   +
+                    +
++ ++                +
+                    +
+++++ ++++++ +++++ + +
+                    +
+ +++++++ + +        +
+ +++++++ S + +      +
+                    +
+ +++                +
++++++++++++++++++ +++
